Account Number,Date,Transaction Type,Amount,Balance
112233,Tue Feb 23 00:23:09 SGT 2021,WITHDRAW,10,20
112233,Tue Feb 23 00:23:12 SGT 2021,WITHDRAW,10,10
112233,Tue Feb 23 00:24:30 SGT 2021,FUND TRANSFER,10,0
112244,Tue Feb 23 00:24:30 SGT 2021,TRANSFER RECEIVED,10,30
112244,Tue Feb 23 00:25:01 SGT 2021,WITHDRAW,10,20
112244,Tue Feb 23 00:25:09 SGT 2021,FUND TRANSFER,20,0
112233,Tue Feb 23 00:25:09 SGT 2021,TRANSFER RECEIVED,20,20
